1111111111111111111111111111111111
1000000000000000000000000000000001
101E111111111111111011111111111101
1000000000000000C110111000000Q01C1
111Q101111111111111011101111010101
10001000000001100000111010C1010101
1011111111110110111111100011010101
1000000000000110111111111111010101
1111111111110110100000000000010101
1011111110000100001111111111Q10101
1000000100111101100001000011110101
1011110001000001001100111011010101
1010001111011110010010000000000001
10101000000100011C1011111111010111
101011C111110100001000000000010001
10Q0111111000111111111111111111101
1C1000000001000000000000000000CQP1
1111111111111111111111111111111111
