1111111111111111
1C000000000000Q1
1111111101011111
11P10000010000C1
1E0101Q101011111
1100010001C11111
1111111111111111
